17,27,27,27,27,17,17,17,17,27,27,27,27,27,27,17,17,17,17,17,17,17,17,17,17,17,17,17,17,17,17,17,17,17,17,17,17,17,17,17
18,03,04,04,05,16,17,17,28,01,01,01,01,01,01,16,17,17,17,17,17,27,27,27,27,27,27,27,27,27,17,17,17,17,17,17,17,17,17,17
18,13,14,14,15,16,17,18,01,11,11,11,12,01,01,16,17,17,17,17,18,03,04,04,04,04,04,04,04,05,26,17,17,17,17,17,17,17,17,17
18,13,14,14,15,16,17,18,01,11,10,10,12,01,01,16,17,17,17,17,18,13,14,14,14,14,14,14,14,14,05,16,17,17,17,17,17,17,17,17
18,13,14,14,15,16,17,18,01,11,10,11,12,06,17,17,17,17,17,17,18,13,14,14,14,14,14,14,14,14,14,16,17,17,17,17,17,17,17,17
18,23,24,24,25,16,17,17,08,01,10,12,12,16,17,17,17,17,17,17,18,13,14,14,14,14,14,14,14,14,14,16,17,17,17,17,17,17,17,17
17,07,08,11,11,16,17,17,18,10,10,12,06,17,17,17,17,17,17,17,18,13,14,14,14,14,14,14,14,14,25,16,17,17,17,17,17,17,17,17
17,17,18,11,11,16,17,27,18,10,12,06,27,27,27,27,27,17,17,17,18,13,14,14,14,14,14,14,14,15,06,17,17,17,17,17,17,17,17,17
17,17,17,08,11,26,28,03,04,04,04,04,04,05,22,22,22,27,27,27,28,23,14,14,14,14,14,14,14,15,27,27,27,27,27,17,17,17,17,17
17,17,17,18,10,11,11,13,14,14,14,14,14,15,02,02,02,02,21,21,21,21,23,24,24,24,24,24,24,25,21,21,21,21,20,16,17,17,17,17
17,17,17,18,10,11,11,13,14,14,14,14,14,15,02,11,21,21,01,01,01,01,06,07,07,07,07,07,08,02,01,01,01,01,20,26,27,27,27,17
17,17,17,18,10,11,11,13,14,14,14,14,14,15,02,11,01,02,11,11,11,11,16,17,17,17,17,17,17,07,07,08,00,01,01,01,01,01,20,26
17,17,17,18,10,21,21,13,14,14,14,14,14,15,02,20,11,11,11,11,11,11,26,17,17,17,17,17,17,17,17,18,12,11,11,11,11,11,01,12
17,17,17,18,00,01,02,23,24,24,24,24,24,25,20,06,07,07,07,08,11,11,20,16,17,17,17,17,17,17,17,18,12,11,11,11,11,11,11,12
17,17,17,18,10,11,12,06,07,07,07,07,07,07,07,17,17,17,17,18,11,11,20,26,17,17,17,17,17,17,17,18,12,11,11,11,11,11,11,12
17,17,17,18,20,21,22,16,17,17,17,17,17,17,17,17,17,17,17,17,07,08,03,04,04,05,16,17,17,17,17,18,12,11,11,11,11,11,11,12
17,17,17,17,07,07,07,17,17,17,17,17,17,17,17,17,17,17,17,17,17,18,13,14,14,15,16,17,17,17,17,18,12,11,11,11,11,11,21,06
17,17,17,17,17,17,17,17,17,17,17,17,17,17,17,17,17,17,17,17,17,18,23,24,24,25,16,17,17,17,17,18,20,21,21,21,21,21,06,17
17,17,17,17,17,17,17,17,17,17,17,17,17,17,17,17,17,17,17,17,17,17,07,07,07,07,17,17,17,17,17,17,07,07,07,07,07,07,17,17
17,17,17,17,17,17,17,17,17,17,17,17,17,17,17,17,17,17,17,17,17,17,17,17,17,17,17,17,17,17,17,17,17,17,17,17,17,17,17,17

1,1,1,1,1,1,1,1,1,1,1,1,1,1,1,1,1,1,1,1,1,1,1,1,1,1,1,1,1,1,1,1,0,0,0,0,0,0,0,0
1,0,0,0,0,0,1,0,0,0,0,0,0,0,0,0,1,1,1,1,0,0,0,0,0,0,0,0,0,0,0,0,1,0,0,0,0,0,0,0
1,0,0,0,0,0,1,0,0,0,0,0,0,0,0,0,1,0,0,1,0,0,0,0,0,0,0,0,0,0,0,0,1,0,0,0,0,0,0,0
1,0,0,0,0,0,1,0,0,0,0,0,0,0,0,0,1,0,0,1,0,0,0,0,0,0,0,0,0,0,0,0,1,0,0,0,0,0,0,0
1,0,0,0,0,0,1,0,0,0,0,0,0,0,0,1,0,0,0,1,0,0,0,0,0,0,0,0,0,0,0,0,1,0,0,0,0,0,0,0
1,0,0,0,0,0,1,0,0,0,0,0,0,0,1,0,0,0,0,1,0,0,0,0,0,0,0,0,0,0,0,0,1,0,0,0,0,0,0,0
1,0,0,0,0,0,1,0,0,0,0,0,0,1,1,1,1,0,0,1,0,0,0,0,0,0,0,0,0,0,0,0,1,0,0,0,0,0,0,0
1,1,0,0,0,0,1,0,0,0,0,0,0,0,0,0,0,1,1,1,0,0,0,0,0,0,0,0,0,0,0,0,1,1,1,1,0,0,0,0
0,1,1,0,0,0,0,0,0,0,0,0,0,0,0,0,0,0,0,0,0,0,0,0,0,0,0,0,0,0,0,0,0,0,0,0,1,0,0,0
0,0,1,0,0,0,0,0,0,0,0,0,0,0,0,0,0,0,0,0,0,0,0,0,0,0,0,0,0,0,0,0,0,0,0,0,1,1,1,1
0,0,1,0,0,0,0,0,0,0,0,0,0,0,0,0,0,0,0,0,0,0,0,0,0,0,0,0,0,0,0,0,0,0,0,0,0,0,0,1
0,0,1,0,0,0,0,0,0,0,0,0,0,0,0,0,0,0,0,0,0,0,0,1,1,1,1,1,0,0,0,0,0,0,0,0,0,0,0,1
0,0,1,0,0,0,0,0,0,0,0,0,0,0,0,0,0,0,0,0,0,0,0,0,1,0,0,0,1,1,0,0,0,0,0,0,0,0,0,1
0,0,1,0,0,0,0,0,0,0,0,0,0,0,0,0,0,0,0,0,0,0,0,0,1,1,1,0,0,1,1,0,0,0,0,0,0,0,0,1
0,0,1,0,0,0,0,0,0,0,0,0,0,0,0,0,1,1,1,0,0,0,0,0,0,0,0,1,0,0,1,0,0,0,0,0,0,0,0,1
0,0,1,0,0,0,0,0,1,1,1,1,1,1,1,1,0,0,1,0,0,0,0,0,0,0,0,1,0,0,1,0,0,0,0,0,0,0,0,1
0,0,1,0,0,0,0,0,1,0,0,0,0,0,0,0,0,0,0,1,0,0,0,0,0,0,0,1,0,0,1,0,0,0,0,0,0,0,0,1
0,0,0,1,1,1,1,1,0,0,0,0,0,0,0,0,0,0,0,0,1,0,0,0,0,0,0,1,0,0,1,0,0,0,0,0,0,0,0,1
0,0,0,0,0,0,0,0,0,0,0,0,0,0,0,0,0,0,0,0,0,1,0,0,0,0,0,1,0,0,1,0,0,0,0,0,0,0,0,1
0,0,0,0,0,0,0,0,0,0,0,0,0,0,0,0,0,0,0,0,0,0,1,1,1,0,1,1,0,0,0,1,1,1,1,1,1,1,1,1

